tahun,bulan,puskesmas,desa,sasaran,sangat pendek,pendek,normal,tinggi,jumlah balita diukur,stunting,stunting (%)
2024,januari,TLANAKAN,AMBAT,602,13,15,286,2,316,28,8.860759494
2024,januari,TLANAKAN,TLANAKAN,327,2,2,123,12,139,4,2.877697842
2024,januari,TLANAKAN,BRANTA PASISIR,695,22,39,197,1,259,61,23.55212355
2024,januari,TLANAKAN,BRANTA TINGGI,229,0,5,163,0,168,5,2.976190476
2024,januari,TLANAKAN,TLESA,115,0,0,1,1,2,0,0
2024,januari,TLANAKAN,LARANGAN TOKOL,659,3,6,420,9,438,9,2.054794521
2024,januari,TLANAKAN,CEGUK,573,3,10,139,5,157,13,8.280254777
2024,januari,TLANAKAN,PANGLEGUR,796,7,5,213,24,249,12,4.819277108
2024,januari,TLANAKAN,GUGUL,645,9,13,266,1,289,22,7.612456747
2024,januari,TLANAKAN,BUKEK,231,11,29,61,0,101,40,39.6039604
2024,januari,PADEMAWU,PADEMAWU BARAT,540,0,0,275,0,275,0,0
2024,januari,PADEMAWU,BUNDER,212,1,1,104,0,106,2,1.886792453
2024,januari,PADEMAWU,DASOK,393,0,1,219,0,220,1,0.454545455
2024,januari,PADEMAWU,MURTAJIH,429,23,10,283,4,320,33,10.3125
2024,januari,PADEMAWU,LEMPER,218,0,0,136,0,136,0,0
2024,januari,PADEMAWU,BARURAMBAT TIMUR,269,0,0,171,0,171,0,0
2024,januari,PADEMAWU,LAWANGAN DAYA,502,11,19,383,6,419,30,7.159904535
2024,januari,PADEMAWU,BUDDAGAN,401,1,2,249,2,254,3,1.181102362
2024,januari,PADEMAWU,TAMBUNG,218,3,0,95,0,98,3,3.06122449
2024,januari,PADEMAWU,SENTOL,416,0,2,174,2,178,2,1.123595506
2024,januari,SOPAAH,BADDURIH,149,0,4,133,1,138,4,2.898550725
2024,januari,SOPAAH,PAGAGAN,191,8,8,147,1,164,16,9.756097561
2024,januari,SOPAAH,MAJUNGAN,131,13,24,78,2,117,37,31.62393162
2024,januari,SOPAAH,PADELEGAN,269,0,0,238,0,238,0,0
2024,januari,SOPAAH,TANJUNG,596,10,53,260,0,323,63,19.50464396
2024,januari,SOPAAH,PADEMAWU TIMUR,523,1,25,402,3,431,26,6.032482599
2024,januari,SOPAAH,JARIN,294,1,8,255,2,266,9,3.383458647
2024,januari,SOPAAH,PREKBUN,86,1,9,64,1,75,10,13.33333333
2024,januari,SOPAAH,SOPA'AH,66,2,7,16,1,26,9,34.61538462
2024,januari,SOPAAH,BUDDIH,76,1,1,69,1,72,2,2.777777778
2024,januari,SOPAAH,DURBUK,207,5,25,169,0,199,30,15.07537688
2024,januari,SOPAAH,SUMEDANGAN,290,1,0,237,0,238,1,0.420168067
2024,januari,GALIS,KONANG,292,5,12,233,25,275,17,6.181818182
2024,januari,GALIS,PANDAN,85,0,3,73,6,82,3,3.658536585
2024,januari,GALIS,LEMBUNG,92,1,0,86,3,90,1,1.111111111
2024,januari,GALIS,GALIS,190,1,0,179,7,187,1,0.534759358
2024,januari,GALIS,BULAY,182,2,3,37,29,71,5,7.042253521
2024,januari,GALIS,TOBUNGAN,208,0,0,89,1,90,0,0
2024,januari,GALIS,PAGENDINGAN,171,2,1,159,9,171,3,1.754385965
2024,januari,GALIS,PONTEH,200,9,21,131,8,169,30,17.75147929
2024,januari,GALIS,POLAGAN,328,1,2,299,11,313,3,0.958466454
2024,januari,GALIS,ARTODUNG,120,12,5,65,6,88,17,19.31818182
2024,januari,LARANGAN,PELTONG,222,1,2,119,0,122,3,2.459016393
2024,januari,LARANGAN,TRASAK,425,4,49,209,0,262,53,20.22900763
2024,januari,LARANGAN,TENTENAN BARAT,116,3,1,81,0,85,4,4.705882353
2024,januari,LARANGAN,TENTENAN TIMUR,166,4,12,99,1,116,16,13.79310345
2024,januari,LARANGAN,GRUJUGAN,321,1,14,138,2,155,15,9.677419355
2024,januari,LARANGAN,BLUMBUNGAN,1441,65,60,659,19,803,125,15.56662516
2024,januari,LARANGAN,LARANGAN LUAR,671,24,44,330,1,399,68,17.04260652
2024,januari,TALANG,LARANGAN DALAM,227,0,5,196,0,201,5,2.487562189
2024,januari,TALANG,PANAGUAN,170,0,8,143,0,151,8,5.298013245
2024,januari,TALANG,MONTOK,218,1,6,191,0,198,7,3.535353535
2024,januari,TALANG,KADUARA BARAT,273,0,4,257,0,261,4,1.53256705
2024,januari,TALANG,LANCAR,121,0,7,103,0,110,7,6.363636364
2024,januari,TALANG,TARABAN,75,0,4,68,0,72,4,5.555555556
2024,januari,TALANG,DUKUH TIMUR,167,1,11,145,0,157,12,7.643312102
2024,januari,TEJA,TEJAH BARAT,254,1,3,241,1,246,4,1.62601626
2024,januari,TEJA,TEJAH TIMUR,244,3,1,198,6,208,4,1.923076923
2024,januari,TEJA,JALMAK,187,0,2,181,0,183,2,1.092896175
2024,januari,TEJA,LADEN,339,1,13,238,3,255,14,5.490196078
2024,januari,TEJA,PANEMPAN,208,0,5,183,0,188,5,2.659574468
2024,januari,TEJA,KANGENAN,359,1,3,343,0,347,4,1.152737752
2024,januari,TEJA,PATEMON,327,1,5,309,1,316,6,1.898734177
2024,januari,TEJA,BARURAMBAT KOTA,555,2,1,535,0,538,3,0.557620818
2024,januari,TEJA,PARTEKER,276,1,2,255,0,258,3,1.162790698
2024,januari,TEJA,JUNGCANGCANG,436,0,9,403,0,412,9,2.184466019
2024,januari,KOWEL,BETTET,328,3,5,175,9,192,8,4.166666667
2024,januari,KOWEL,NYLABU LAOK,290,10,8,137,1,156,18,11.53846154
2024,januari,KOWEL,NYLABU DAYA,479,1,4,178,1,184,5,2.717391304
2024,januari,KOWEL,BUGIH,787,2,7,423,14,446,9,2.01793722
2024,januari,KOWEL,GLADAK ANYAR,1222,0,1,612,3,616,1,0.162337662
2024,januari,KOWEL,KOLPAJUNG,548,0,3,404,8,415,3,0.722891566
2024,januari,KOWEL,KOWEL,713,1,7,423,0,431,8,1.856148492
2024,januari,KOWEL,TORONAN,273,0,3,196,0,199,3,1.507537688
2024,januari,PROPPO,TOKET,256,0,0,7,0,7,0,0
2024,januari,PROPPO,KARANGANYAR,144,1,3,72,3,79,4,5.063291139
2024,januari,PROPPO,SAMIRAN,218,3,3,63,0,69,6,8.695652174
2024,januari,PROPPO,PROPPO,255,1,7,98,1,107,8,7.476635514
2024,januari,PROPPO,MAPPER,253,1,0,88,0,89,1,1.123595506
2024,januari,PROPPO,PANGLEMAH,143,5,10,74,1,90,15,16.66666667
2024,januari,PROPPO,BILLA'AN,296,1,0,13,0,14,1,7.142857143
2024,januari,PROPPO,TLANGOH,201,2,4,102,4,112,6,5.357142857
2024,januari,PROPPO,KODIK,139,0,4,68,1,73,4,5.479452055
2024,januari,PROPPO,LENTENG,95,0,1,30,0,31,1,3.225806452
2024,januari,PROPPO,SAMATAN,201,1,19,173,1,194,20,10.30927835
2024,januari,PROPPO,KLAMPAR,464,2,3,163,9,177,5,2.824858757
2024,januari,PROPPO,RANG PERANG LAOK,210,0,2,91,2,95,2,2.105263158
2024,januari,PROPPO,PANGURAYAN,224,1,1,67,0,69,2,2.898550725
2024,januari,PROPPO,BANYUBULU,310,0,6,125,6,137,6,4.379562044
2024,januari,PROPPO,RANG PERANG DAYA,187,1,2,144,3,150,3,2
2024,januari,PANAGUAN,GRO'OM,232,0,0,177,3,180,0,0
2024,januari,PANAGUAN,BATUKALANGAN,294,10,8,92,77,187,18,9.625668449
2024,januari,PANAGUAN,CANDIBURUNG,278,15,18,107,1,141,33,23.40425532
2024,januari,PANAGUAN,PANGTONGGAL,368,22,31,125,0,178,53,29.7752809
2024,januari,PANAGUAN,SRAMBAH,336,10,9,143,1,163,19,11.65644172
2024,januari,PANAGUAN,BADUNG,314,15,11,77,19,122,26,21.31147541
2024,januari,PANAGUAN,TATTANGOH,347,20,20,94,0,134,40,29.85074627
2024,januari,PANAGUAN,PANGBATOK,284,8,1,173,0,182,9,4.945054945
2024,januari,PANAGUAN,PANAGUAN,428,3,4,364,0,371,7,1.886792453
2024,januari,PANAGUAN,CAMPOR,298,15,2,223,9,249,17,6.827309237
2024,januari,PANAGUAN,JAMBRINGIN,311,8,23,280,2,313,31,9.904153355
2024,januari,PALENGAAN,BANYUPELLE,970,3,1,697,122,823,4,0.486026731
2024,januari,PALENGAAN,REK KERREK,1074,5,10,993,35,1043,15,1.438159156
2024,januari,PALENGAAN,ROMBUH,244,0,0,244,2,246,0,0
2024,januari,PALENGAAN,PALENGAAN LAOK,1105,4,3,780,9,796,7,0.879396985
2024,januari,PALENGAAN,PALENGAAN DAJA,1052,2,4,928,85,1019,6,0.588812561
2024,januari,PEGANTENAN,BULANGAN BARAT,267,0,0,263,0,263,0,0
2024,januari,PEGANTENAN,PALESANGGAR,555,6,27,433,0,466,33,7.081545064
2024,januari,PEGANTENAN,PEGANTENAN,256,0,7,223,1,231,7,3.03030303
2024,januari,PEGANTENAN,TEBUL TIMUR,206,0,0,190,0,190,0,0
2024,januari,PEGANTENAN,TEBUL BARAT,95,0,2,84,0,86,2,2.325581395
2024,januari,PEGANTENAN,AMBENDER,323,3,3,315,0,321,6,1.869158879
2024,januari,PEGANTENAN,PASANGGAR,596,0,3,492,1,496,3,0.60483871
2024,januari,PEGANTENAN,TANJUNG,395,2,68,312,2,384,70,18.22916667
2024,januari,BULANGAN HAJI,PLAKPAK,725,2,7,405,24,438,9,2.054794521
2024,januari,BULANGAN HAJI,BULANGAN HAJI,405,0,6,228,1,235,6,2.553191489
2024,januari,BULANGAN HAJI,TALAGAH,138,0,3,106,0,109,3,2.752293578
2024,januari,BULANGAN HAJI,BULANGAN TIMUR,308,0,4,146,0,150,4,2.666666667
2024,januari,BULANGAN HAJI,BULANGAN BRANTA,166,0,1,60,0,61,1,1.639344262
2024,januari,KADUR,PAMAROH,335,5,21,242,0,268,26,9.701492537
2024,januari,KADUR,PAMOROH,1055,11,13,584,6,614,24,3.908794788
2024,januari,KADUR,BANGKES,1217,11,24,550,14,599,35,5.843071786
2024,januari,KADUR,KADUR,995,2,16,543,25,586,18,3.071672355
2024,januari,KADUR,BUNGBARUH,490,1,18,315,2,336,19,5.654761905
2024,januari,KADUR,SOKOLELAH,147,0,5,107,1,113,5,4.424778761
2024,januari,KADUR,GAGAH,95,0,4,61,2,67,4,5.970149254
2024,januari,KADUR,KERTAGENA LAOK,155,0,7,140,0,147,7,4.761904762
2024,januari,KADUR,KERTAGENA TENGAH,504,6,26,260,2,294,32,10.88435374
2024,januari,KADUR,KERTAGENA DAYA,443,0,5,265,1,271,5,1.84501845
2024,januari,PAKONG,BICORONG,328,1,0,258,0,259,1,0.386100386
2024,januari,PAKONG,KLOMPANG BARAT,206,0,2,196,0,198,2,1.01010101
2024,januari,PAKONG,KLOMPANG TIMUR,58,0,0,48,0,48,0,0
2024,januari,PAKONG,BAJANG,113,0,5,107,0,112,5,4.464285714
2024,januari,PAKONG,CENLECEN,216,0,3,200,0,203,3,1.477832512
2024,januari,PAKONG,BANBAN,57,1,0,47,0,48,1,2.083333333
2024,januari,PAKONG,SOMALANG,75,0,1,76,0,77,1,1.298701299
2024,januari,PAKONG,PALALANG,86,0,1,84,0,85,1,1.176470588
2024,januari,PAKONG,SEDDUR,358,0,0,201,0,201,0,0
2024,januari,PAKONG,PAKONG,394,0,2,383,0,385,2,0.519480519
2024,januari,PAKONG,BANDUNGAN,208,0,0,174,0,174,0,0
2024,januari,PAKONG,LEBBEK,306,2,1,255,0,258,3,1.162790698
2024,januari,WARU,SANA LAOK,393,32,14,395,6,447,46,10.29082774
2024,januari,WARU,WARU TIMUR,662,16,16,604,5,641,32,4.992199688
2024,januari,WARU,WARU BARAT,646,23,10,607,5,645,33,5.11627907
2024,januari,WARU,TLONTOARES,130,8,5,130,1,144,13,9.027777778
2024,januari,WARU,TEGANGSER LAOK,172,15,5,152,1,173,20,11.56069364
2024,januari,TAMPOJUNG PREGI,SUMBER WARU,329,0,2,284,4,290,2,0.689655172
2024,januari,TAMPOJUNG PREGI,BAJUR,284,3,1,132,64,200,4,2
2024,januari,TAMPOJUNG PREGI,RAGANG,262,0,2,216,0,218,2,0.917431193
2024,januari,TAMPOJUNG PREGI,TAMPOJUNG TENGGINA,219,0,2,182,11,195,2,1.025641026
2024,januari,TAMPOJUNG PREGI,TAMPOJUNG TENGAH,163,0,2,143,0,145,2,1.379310345
2024,januari,TAMPOJUNG PREGI,TAMPOJUNG GUWA,74,0,0,68,0,68,0,0
2024,januari,TAMPOJUNG PREGI,TAMPOJUNG PREGI,420,4,5,366,20,395,9,2.278481013
2024,januari,BATUMARMAR,PANGERREMAN,282,0,4,244,0,248,4,1.612903226
2024,januari,BATUMARMAR,BUJUR BARAT,729,0,3,718,0,721,3,0.416088766
2024,januari,BATUMARMAR,BUJUR TENGAH,499,0,6,489,0,495,6,1.212121212
2024,januari,BATUMARMAR,BUJUR TIMUR,443,0,0,440,0,440,0,0
2024,januari,BATUMARMAR,PONJANAN TIMUR,622,0,19,585,0,604,19,3.145695364
2024,januari,BATUMARMAR,PONJANAN BARAT,329,0,4,305,0,309,4,1.294498382
2024,januari,BATUMARMAR,LESONG LAOK,240,0,1,194,0,195,1,0.512820513
2024,januari,BATUMARMAR,BANGSEREH,358,0,4,283,0,287,4,1.393728223
2024,januari,BATUMARMAR,BLABAN,463,0,12,451,0,463,12,2.591792657
2024,januari,BATUMARMAR,TAMBERU,39,0,0,2,0,2,0,0
2024,januari,BATUMARMAR,BATUBINTANG,935,0,2,496,0,498,2,0.401606426
2024,januari,BATUMARMAR,LESONG DAJA,348,0,5,189,0,194,5,2.577319588
2024,januari,BATUMARMAR,KAPONG,267,0,1,246,0,247,1,0.4048583
2024,januari,PASEAN,SANA TENGAH,343,10,4,298,6,318,14,4.402515723
2024,januari,PASEAN,SANA DAJA,277,14,6,308,5,333,20,6.006006006
2024,januari,PASEAN,DEMPO BARAT,302,0,4,308,4,316,4,1.265822785
2024,januari,PASEAN,DEMPO TIMUR,172,0,3,168,0,171,3,1.754385965
2024,januari,PASEAN,BINDANG,336,0,5,326,13,344,5,1.453488372
2024,januari,PASEAN,BATUKERBUY,326,0,4,321,0,325,4,1.230769231
2024,januari,PASEAN,TLONTORAJA,469,4,8,468,0,480,12,2.5
2024,januari,PASEAN,TAGANGSER DAJA,210,1,4,203,1,209,5,2.392344498
2024,januari,PASEAN,SOTABAR,268,4,5,255,4,268,9,3.358208955
2024,januari,BANDARAN,DABUAN,147,0,11,123,0,134,11,8.208955224
2024,januari,BANDARAN,TERRAK,289,1,10,186,0,197,11,5.583756345
2024,januari,BANDARAN,MANGGAR,143,0,6,112,0,118,6,5.084745763
2024,januari,BANDARAN,BANDARAN,335,0,7,307,2,316,7,2.215189873
2024,januari,BANDARAN,KRAMAT,432,1,7,317,20,345,8,2.31884058
2024,januari,BANDARAN,LARANGAN SLAMPAR,373,0,4,222,6,232,4,1.724137931
2024,januari,BANDARAN,TARO'AN,158,0,4,164,2,170,4,2.352941176
2024,januari,LARANGAN BADUNG,ANGSANAH,321,0,1,287,3,291,1,0.343642612
2024,januari,LARANGAN BADUNG,AKKOR,260,2,0,221,2,225,2,0.888888889
2024,januari,LARANGAN BADUNG,LARANGAN BADUNG,563,0,0,510,10,520,0,0
2024,januari,LARANGAN BADUNG,PANAAN,221,0,0,185,8,193,0,0
2024,januari,LARANGAN BADUNG,POTOAN LAOK,240,0,0,214,1,215,0,0
2024,januari,LARANGAN BADUNG,POTOAN DAJA,261,0,0,228,19,247,0,0
2024,januari,LARANGAN BADUNG,KACOK,280,0,0,146,105,251,0,0
2024,februari,TLANAKAN,AMBAT,588,2,11,202,2,217,13,5.99078341
2024,februari,TLANAKAN,TLANAKAN,317,2,5,109,17,133,7,5.263157895
2024,februari,TLANAKAN,BRANTA PASISIR,691,2,20,313,2,337,22,6.528189911
2024,februari,TLANAKAN,BRANTA TINGGI,227,0,8,158,0,166,8,4.819277108
2024,februari,TLANAKAN,TLESA,114,2,2,50,1,55,4,7.272727273
2024,februari,TLANAKAN,LARANGAN TOKOL,652,2,6,405,8,421,8,1.90023753
2024,februari,TLANAKAN,CEGUK,569,1,7,148,6,162,8,4.938271605
2024,februari,TLANAKAN,PANGLEGUR,784,4,8,259,34,305,12,3.93442623
2024,februari,TLANAKAN,GUGUL,637,3,16,266,3,288,19,6.597222222
2024,februari,TLANAKAN,BUKEK,232,10,33,59,1,103,43,41.74757282
2024,februari,PADEMAWU,PADEMAWU BARAT,529,4,6,353,1,364,10,2.747252747
2024,februari,PADEMAWU,BUNDER,207,1,3,130,1,135,4,2.962962963
2024,februari,PADEMAWU,DASOK,386,10,2,332,0,344,12,3.488372093
2024,februari,PADEMAWU,MURTAJIH,427,10,8,351,2,371,18,4.851752022
2024,februari,PADEMAWU,LEMPER,214,0,0,134,0,134,0,0
2024,februari,PADEMAWU,BARURAMBAT TIMUR,261,0,1,164,0,165,1,0.606060606
2024,februari,PADEMAWU,LAWANGAN DAYA,493,7,7,242,8,264,14,5.303030303
2024,februari,PADEMAWU,BUDDAGAN,392,5,6,316,3,330,11,3.333333333
2024,februari,PADEMAWU,TAMBUNG,206,3,0,163,1,167,3,1.796407186
2024,februari,PADEMAWU,SENTOL,415,2,1,240,6,249,3,1.204819277
2024,februari,SOPAAH,BADDURIH,145,0,0,137,1,138,0,0
2024,februari,SOPAAH,PAGAGAN,189,0,4,164,0,168,4,2.380952381
2024,februari,SOPAAH,MAJUNGAN,126,8,16,94,1,119,24,20.16806723
2024,februari,SOPAAH,PADELEGAN,265,0,1,238,0,239,1,0.418410042
2024,februari,SOPAAH,TANJUNG,590,11,68,364,1,444,79,17.79279279
2024,februari,SOPAAH,PADEMAWU TIMUR,515,0,4,397,2,403,4,0.992555831
2024,februari,SOPAAH,JARIN,285,0,1,268,6,275,1,0.363636364
2024,februari,SOPAAH,PREKBUN,86,0,5,77,1,83,5,6.024096386
2024,februari,SOPAAH,SOPA'AH,63,2,2,50,0,54,4,7.407407407
2024,februari,SOPAAH,BUDDIH,76,1,0,73,1,75,1,1.333333333
2024,februari,SOPAAH,DURBUK,207,2,15,187,1,205,17,8.292682927
2024,februari,SOPAAH,SUMEDANGAN,291,0,1,267,1,269,1,0.371747212
2024,februari,GALIS,KONANG,291,4,6,201,27,238,10,4.201680672
2024,februari,GALIS,PANDAN,82,0,2,76,4,82,2,2.43902439
2024,februari,GALIS,LEMBUNG,92,0,2,87,2,91,2,2.197802198
2024,februari,GALIS,GALIS,187,1,1,177,5,184,2,1.086956522
2024,februari,GALIS,BULAY,183,2,0,29,23,54,2,3.703703704
2024,februari,GALIS,TOBUNGAN,207,2,0,199,4,205,2,0.975609756
2024,februari,GALIS,PAGENDINGAN,162,0,2,149,9,160,2,1.25
2024,februari,GALIS,PONTEH,193,0,1,98,58,157,1,0.636942675
2024,februari,GALIS,POLAGAN,324,2,2,302,9,315,4,1.26984127
2024,februari,GALIS,ARTODUNG,117,4,5,102,1,112,9,8.035714286
2024,februari,LARANGAN,PELTONG,216,0,0,120,0,120,0,0
2024,februari,LARANGAN,TRASAK,410,0,15,262,0,277,15,5.415162455
2024,februari,LARANGAN,TENTENAN BARAT,115,3,11,67,0,81,14,17.28395062
2024,februari,LARANGAN,TENTENAN TIMUR,160,2,6,83,0,91,8,8.791208791
2024,februari,LARANGAN,GRUJUGAN,309,2,7,147,0,156,9,5.769230769
2024,februari,LARANGAN,BLUMBUNGAN,1413,0,5,715,87,807,5,0.619578686
2024,februari,LARANGAN,LARANGAN LUAR,654,8,6,370,0,384,14,3.645833333
2024,februari,TALANG,LARANGAN DALAM,220,0,4,198,0,202,4,1.98019802
2024,februari,TALANG,PANAGUAN,164,0,6,143,0,149,6,4.026845638
2024,februari,TALANG,MONTOK,212,0,6,188,1,195,6,3.076923077
2024,februari,TALANG,KADUARA BARAT,268,0,7,247,0,254,7,2.755905512
2024,februari,TALANG,LANCAR,118,0,6,103,0,109,6,5.504587156
2024,februari,TALANG,TARABAN,73,0,3,67,0,70,3,4.285714286
2024,februari,TALANG,DUKUH TIMUR,164,0,10,151,0,161,10,6.211180124
2024,februari,TEJA,TEJAH BARAT,244,3,3,232,1,239,6,2.510460251
2024,februari,TEJA,TEJAH TIMUR,241,3,1,197,5,206,4,1.941747573
2024,februari,TEJA,JALMAK,183,0,3,170,0,173,3,1.734104046
2024,februari,TEJA,LADEN,333,6,13,234,3,256,19,7.421875
2024,februari,TEJA,PANEMPAN,206,0,5,179,0,184,5,2.717391304
2024,februari,TEJA,KANGENAN,356,2,5,345,1,353,7,1.983002833
2024,februari,TEJA,PATEMON,324,0,4,309,1,314,4,1.27388535
2024,februari,TEJA,BARURAMBAT KOTA,542,2,1,521,0,524,3,0.572519084
2024,februari,TEJA,PARTEKER,268,2,2,255,0,259,4,1.544401544
2024,februari,TEJA,JUNGCANGCANG,421,0,6,400,0,406,6,1.477832512
2024,februari,KOWEL,BETTET,319,3,0,151,15,169,3,1.775147929
2024,februari,KOWEL,NYLABU LAOK,285,8,10,135,1,154,18,11.68831169
2024,februari,KOWEL,NYLABU DAYA,475,1,1,174,1,177,2,1.129943503
2024,februari,KOWEL,BUGIH,772,1,10,424,2,437,11,2.517162471
2024,februari,KOWEL,GLADAK ANYAR,1188,0,2,568,2,572,2,0.34965035
2024,februari,KOWEL,KOLPAJUNG,538,1,9,384,7,401,10,2.493765586
2024,februari,KOWEL,KOWEL,699,2,9,386,0,397,11,2.770780856
2024,februari,KOWEL,TORONAN,259,0,3,186,0,189,3,1.587301587
2024,februari,PROPPO,TOKET,255,0,1,157,0,158,1,0.632911392
2024,februari,PROPPO,KARANGANYAR,143,1,7,68,1,77,8,10.38961039
2024,februari,PROPPO,SAMIRAN,216,4,4,116,4,128,8,6.25
2024,februari,PROPPO,PROPPO,251,10,17,79,1,107,27,25.23364486
2024,februari,PROPPO,MAPPER,248,1,0,90,0,91,1,1.098901099
2024,februari,PROPPO,PANGLEMAH,141,5,9,70,1,85,14,16.47058824
2024,februari,PROPPO,BILLA'AN,295,1,0,7,0,8,1,12.5
2024,februari,PROPPO,TLANGOH,196,2,3,114,1,120,5,4.166666667
2024,februari,PROPPO,KODIK,138,9,2,61,1,73,11,15.06849315
2024,februari,PROPPO,LENTENG,94,0,0,35,0,35,0,0
2024,februari,PROPPO,SAMATAN,197,1,14,130,0,145,15,10.34482759
2024,februari,PROPPO,KLAMPAR,461,3,2,206,6,217,5,2.304147465
2024,februari,PROPPO,RANG PERANG LAOK,212,0,2,88,0,90,2,2.222222222
2024,februari,PROPPO,PANGURAYAN,224,2,1,68,0,71,3,4.225352113
2024,februari,PROPPO,BANYUBULU,304,34,15,74,4,127,49,38.58267717
2024,februari,PROPPO,RANG PERANG DAYA,182,1,2,147,2,152,3,1.973684211
2024,februari,PANAGUAN,GRO'OM,227,0,0,177,2,179,0,0
2024,februari,PANAGUAN,BATUKALANGAN,292,8,7,114,69,198,15,7.575757576
2024,februari,PANAGUAN,CANDIBURUNG,269,14,20,154,1,189,34,17.98941799
2024,februari,PANAGUAN,PANGTONGGAL,358,33,43,129,0,205,76,37.07317073
2024,februari,PANAGUAN,SRAMBAH,333,8,6,161,0,175,14,8
2024,februari,PANAGUAN,BADUNG,300,26,7,112,23,168,33,19.64285714
2024,februari,PANAGUAN,TATTANGOH,343,31,21,112,2,166,52,31.3253012
2024,februari,PANAGUAN,PANGBATOK,279,8,0,169,0,177,8,4.519774011
2024,februari,PANAGUAN,PANAGUAN,420,3,4,355,1,363,7,1.928374656
2024,februari,PANAGUAN,CAMPOR,294,1,1,282,17,301,2,0.664451827
2024,februari,PANAGUAN,JAMBRINGIN,308,2,3,284,4,293,5,1.706484642
2024,februari,PALENGAAN,BANYUPELLE,979,3,2,692,131,828,5,0.603864734
2024,februari,PALENGAAN,REK KERREK,1079,5,8,991,35,1039,13,1.25120308
2024,februari,PALENGAAN,ROMBUH,240,0,0,239,3,242,0,0
2024,februari,PALENGAAN,PALENGAAN LAOK,1105,3,4,775,15,797,7,0.878293601
2024,februari,PALENGAAN,PALENGAAN DAJA,1057,2,4,922,99,1027,6,0.584225901
2024,februari,PEGANTENAN,BULANGAN BARAT,266,0,0,262,0,262,0,0
2024,februari,PEGANTENAN,PALESANGGAR,548,8,29,634,2,673,37,5.497771174
2024,februari,PEGANTENAN,PEGANTENAN,248,0,7,215,1,223,7,3.139013453
2024,februari,PEGANTENAN,TEBUL TIMUR,204,0,0,184,0,184,0,0
2024,februari,PEGANTENAN,TEBUL BARAT,95,0,1,84,0,85,1,1.176470588
2024,februari,PEGANTENAN,AMBENDER,317,3,2,308,0,313,5,1.597444089
2024,februari,PEGANTENAN,PASANGGAR,593,0,2,490,1,493,2,0.405679513
2024,februari,PEGANTENAN,TANJUNG,394,2,2,375,2,381,4,1.049868766
2024,februari,BULANGAN HAJI,PLAKPAK,701,0,8,392,2,402,8,1.990049751
2024,februari,BULANGAN HAJI,BULANGAN HAJI,403,1,4,435,1,441,5,1.133786848
2024,februari,BULANGAN HAJI,TALAGAH,136,0,3,98,0,101,3,2.97029703
2024,februari,BULANGAN HAJI,BULANGAN TIMUR,306,0,1,247,3,251,1,0.398406375
2024,februari,BULANGAN HAJI,BULANGAN BRANTA,160,0,2,155,0,157,2,1.27388535
2024,februari,KADUR,PAMAROH,331,3,20,240,0,263,23,8.745247148
2024,februari,KADUR,PAMOROH,1039,15,14,297,5,331,29,8.761329305
2024,februari,KADUR,BANGKES,1187,27,73,399,19,518,100,19.30501931
2024,februari,KADUR,KADUR,981,12,31,391,7,441,43,9.750566893
2024,februari,KADUR,BUNGBARUH,472,2,12,312,2,328,14,4.268292683
2024,februari,KADUR,SOKOLELAH,147,0,0,111,0,111,0,0
2024,februari,KADUR,GAGAH,91,0,1,66,0,67,1,1.492537313
2024,februari,KADUR,KERTAGENA LAOK,154,3,12,131,0,146,15,10.2739726
2024,februari,KADUR,KERTAGENA TENGAH,498,8,14,146,2,170,22,12.94117647
2024,februari,KADUR,KERTAGENA DAYA,418,12,31,117,4,164,43,26.2195122
2024,februari,PAKONG,BICORONG,314,0,1,245,0,246,1,0.406504065
2024,februari,PAKONG,KLOMPANG BARAT,206,0,0,198,0,198,0,0
2024,februari,PAKONG,KLOMPANG TIMUR,54,0,0,45,0,45,0,0
2024,februari,PAKONG,BAJANG,113,0,0,112,0,112,0,0
2024,februari,PAKONG,CENLECEN,211,0,0,200,0,200,0,0
2024,februari,PAKONG,BANBAN,56,0,0,51,0,51,0,0
2024,februari,PAKONG,SOMALANG,72,7,6,59,0,72,13,18.05555556
2024,februari,PAKONG,PALALANG,82,0,0,80,0,80,0,0
2024,februari,PAKONG,SEDDUR,340,0,0,186,0,186,0,0
2024,februari,PAKONG,PAKONG,392,0,0,377,0,377,0,0
2024,februari,PAKONG,BANDUNGAN,200,0,0,170,0,170,0,0
2024,februari,PAKONG,LEBBEK,300,68,22,119,0,209,90,43.06220096
2024,februari,WARU,SANA LAOK,390,35,17,411,4,467,52,11.13490364
2024,februari,WARU,WARU TIMUR,652,16,18,597,2,633,34,5.371248025
2024,februari,WARU,WARU BARAT,629,23,7,596,5,631,30,4.754358162
2024,februari,WARU,TLONTOARES,130,12,4,128,1,145,16,11.03448276
2024,februari,WARU,TEGANGSER LAOK,170,17,4,150,1,172,21,12.20930233
2024,februari,TAMPOJUNG PREGI,SUMBER WARU,321,1,4,304,6,315,5,1.587301587
2024,februari,TAMPOJUNG PREGI,BAJUR,282,0,4,163,63,230,4,1.739130435
2024,februari,TAMPOJUNG PREGI,RAGANG,254,1,2,235,0,238,3,1.260504202
2024,februari,TAMPOJUNG PREGI,TAMPOJUNG TENGGINA,213,0,1,178,11,190,1,0.526315789
2024,februari,TAMPOJUNG PREGI,TAMPOJUNG TENGAH,160,1,0,150,1,152,1,0.657894737
2024,februari,TAMPOJUNG PREGI,TAMPOJUNG GUWA,73,2,0,70,0,72,2,2.777777778
2024,februari,TAMPOJUNG PREGI,TAMPOJUNG PREGI,414,0,2,376,18,396,2,0.505050505
2024,februari,BATUMARMAR,PANGERREMAN,274,0,0,166,0,166,0,0
2024,februari,BATUMARMAR,BUJUR BARAT,716,0,2,709,0,711,2,0.281293952
2024,februari,BATUMARMAR,BUJUR TENGAH,493,0,8,481,0,489,8,1.63599182
2024,februari,BATUMARMAR,BUJUR TIMUR,433,0,0,430,0,430,0,0
2024,februari,BATUMARMAR,PONJANAN TIMUR,600,1,9,573,0,583,10,1.715265866
2024,februari,BATUMARMAR,PONJANAN BARAT,328,0,2,306,0,308,2,0.649350649
2024,februari,BATUMARMAR,LESONG LAOK,237,0,2,190,0,192,2,1.041666667
2024,februari,BATUMARMAR,BANGSEREH,353,0,4,278,0,282,4,1.418439716
2024,februari,BATUMARMAR,BLABAN,456,0,15,441,0,456,15,3.289473684
2024,februari,BATUMARMAR,TAMBERU,38,0,0,1,0,1,0,0
2024,februari,BATUMARMAR,BATUBINTANG,915,0,8,735,0,743,8,1.076716016
2024,februari,BATUMARMAR,LESONG DAJA,346,0,7,186,0,193,7,3.626943005
2024,februari,BATUMARMAR,KAPONG,258,0,4,232,0,236,4,1.694915254
2024,februari,PASEAN,SANA TENGAH,328,2,3,409,2,416,5,1.201923077
2024,februari,PASEAN,SANA DAJA,268,1,3,395,1,400,4,1
2024,februari,PASEAN,DEMPO BARAT,295,0,4,314,0,318,4,1.257861635
2024,februari,PASEAN,DEMPO TIMUR,167,0,3,329,0,332,3,0.903614458
2024,februari,PASEAN,BINDANG,332,0,5,401,10,416,5,1.201923077
2024,februari,PASEAN,BATUKERBUY,316,0,4,451,0,455,4,0.879120879
2024,februari,PASEAN,TLONTORAJA,455,0,7,545,0,552,7,1.268115942
2024,februari,PASEAN,TAGANGSER DAJA,203,1,4,286,1,292,5,1.712328767
2024,februari,PASEAN,SOTABAR,260,0,4,301,0,305,4,1.31147541
2024,februari,BANDARAN,DABUAN,143,0,8,123,0,131,8,6.106870229
2024,februari,BANDARAN,TERRAK,280,0,3,198,9,210,3,1.428571429
2024,februari,BANDARAN,MANGGAR,139,0,5,110,0,115,5,4.347826087
2024,februari,BANDARAN,BANDARAN,328,1,7,321,3,332,8,2.409638554
2024,februari,BANDARAN,KRAMAT,421,0,8,313,17,338,8,2.366863905
2024,februari,BANDARAN,LARANGAN SLAMPAR,368,0,3,224,5,232,3,1.293103448
2024,februari,BANDARAN,TARO'AN,156,0,2,165,2,169,2,1.183431953
2024,februari,LARANGAN BADUNG,ANGSANAH,319,0,1,289,5,295,1,0.338983051
2024,februari,LARANGAN BADUNG,AKKOR,255,2,1,218,3,224,3,1.339285714
2024,februari,LARANGAN BADUNG,LARANGAN BADUNG,560,0,0,491,15,506,0,0
2024,februari,LARANGAN BADUNG,PANAAN,220,0,0,178,17,195,0,0
2024,februari,LARANGAN BADUNG,POTOAN LAOK,233,0,0,200,4,204,0,0
2024,februari,LARANGAN BADUNG,POTOAN DAJA,260,0,0,234,20,254,0,0
2024,februari,LARANGAN BADUNG,KACOK,279,0,0,117,128,245,0,0
2024,maret,TLANAKAN,AMBAT,575,4,13,282,3,302,17,5.629139073
2024,maret,TLANAKAN,TLANAKAN,307,2,6,100,20,128,8,6.25
2024,maret,TLANAKAN,BRANTA PASISIR,690,3,15,318,1,337,18,5.341246291
2024,maret,TLANAKAN,BRANTA TINGGI,221,0,5,159,0,164,5,3.048780488
2024,maret,TLANAKAN,TLESA,110,1,1,50,0,52,2,3.846153846
2024,maret,TLANAKAN,LARANGAN TOKOL,648,6,12,443,10,471,18,3.821656051
2024,maret,TLANAKAN,CEGUK,535,1,10,135,5,151,11,7.284768212
2024,maret,TLANAKAN,PANGLEGUR,766,5,16,245,40,306,21,6.862745098
2024,maret,TLANAKAN,GUGUL,622,3,9,275,3,290,12,4.137931034
2024,maret,TLANAKAN,BUKEK,229,10,40,59,1,110,50,45.45454545
2024,maret,PADEMAWU,PADEMAWU BARAT,522,1,3,417,0,421,4,0.950118765
2024,maret,PADEMAWU,BUNDER,206,0,3,158,1,162,3,1.851851852
2024,maret,PADEMAWU,DASOK,384,2,2,359,0,363,4,1.101928375
2024,maret,PADEMAWU,MURTAJIH,421,4,6,406,2,418,10,2.392344498
2024,maret,PADEMAWU,LEMPER,210,2,4,163,0,169,6,3.550295858
2024,maret,PADEMAWU,BARURAMBAT TIMUR,251,0,1,255,0,256,1,0.390625
2024,maret,PADEMAWU,LAWANGAN DAYA,490,3,8,474,11,496,11,2.217741935
2024,maret,PADEMAWU,BUDDAGAN,386,4,10,335,3,352,14,3.977272727
2024,maret,PADEMAWU,TAMBUNG,197,4,0,182,2,188,4,2.127659574
2024,maret,PADEMAWU,SENTOL,407,1,1,246,5,253,2,0.790513834
2024,maret,SOPAAH,BADDURIH,137,0,0,132,1,133,0,0
2024,maret,SOPAAH,PAGAGAN,187,0,3,163,0,166,3,1.807228916
2024,maret,SOPAAH,MAJUNGAN,124,2,5,108,2,117,7,5.982905983
2024,maret,SOPAAH,PADELEGAN,264,0,0,234,0,234,0,0
2024,maret,SOPAAH,TANJUNG,582,3,39,278,2,322,42,13.04347826
2024,maret,SOPAAH,PADEMAWU TIMUR,509,0,4,365,2,371,4,1.078167116
2024,maret,SOPAAH,JARIN,284,0,0,236,5,241,0,0
2024,maret,SOPAAH,PREKBUN,85,0,4,61,1,66,4,6.060606061
2024,maret,SOPAAH,SOPA'AH,62,3,2,44,3,52,5,9.615384615
2024,maret,SOPAAH,BUDDIH,75,0,2,71,2,75,2,2.666666667
2024,maret,SOPAAH,DURBUK,205,0,3,130,0,133,3,2.255639098
2024,maret,SOPAAH,SUMEDANGAN,286,0,0,262,1,263,0,0
2024,maret,GALIS,KONANG,287,4,7,222,29,262,11,4.198473282
2024,maret,GALIS,PANDAN,81,2,3,73,2,80,5,6.25
2024,maret,GALIS,LEMBUNG,92,1,1,84,3,89,2,2.247191011
2024,maret,GALIS,GALIS,185,1,0,182,6,189,1,0.529100529
2024,maret,GALIS,BULAY,183,3,1,29,0,33,4,12.12121212
2024,maret,GALIS,TOBUNGAN,201,2,0,182,9,193,2,1.03626943
2024,maret,GALIS,PAGENDINGAN,158,2,1,152,4,159,3,1.886792453
2024,maret,GALIS,PONTEH,188,0,2,107,45,154,2,1.298701299
2024,maret,GALIS,POLAGAN,317,1,3,294,9,307,4,1.302931596
2024,maret,GALIS,ARTODUNG,117,2,3,111,0,116,5,4.310344828
2024,maret,LARANGAN,PELTONG,216,0,0,119,0,119,0,0
2024,maret,LARANGAN,TRASAK,414,0,8,265,0,273,8,2.93040293
2024,maret,LARANGAN,TENTENAN BARAT,114,1,2,80,0,83,3,3.614457831
2024,maret,LARANGAN,TENTENAN TIMUR,159,2,6,80,1,89,8,8.988764045
2024,maret,LARANGAN,GRUJUGAN,305,1,0,146,0,147,1,0.680272109
2024,maret,LARANGAN,BLUMBUNGAN,1397,1,4,674,79,758,5,0.659630607
2024,maret,LARANGAN,LARANGAN LUAR,635,5,6,379,0,390,11,2.820512821
2024,maret,TALANG,LARANGAN DALAM,215,0,3,255,0,258,3,1.162790698
2024,maret,TALANG,PANAGUAN,160,0,6,156,0,162,6,3.703703704
2024,maret,TALANG,MONTOK,209,0,6,200,0,206,6,2.912621359
2024,maret,TALANG,KADUARA BARAT,264,0,7,254,0,261,7,2.681992337
2024,maret,TALANG,LANCAR,117,0,5,114,0,119,5,4.201680672
2024,maret,TALANG,TARABAN,71,0,3,76,0,79,3,3.797468354
2024,maret,TALANG,DUKUH TIMUR,162,0,10,156,0,166,10,6.024096386
2024,maret,TEJA,TEJAH BARAT,242,1,4,227,2,234,5,2.136752137
2024,maret,TEJA,TEJAH TIMUR,240,4,6,202,4,216,10,4.62962963
2024,maret,TEJA,JALMAK,182,0,1,168,0,169,1,0.591715976
2024,maret,TEJA,LADEN,328,6,14,227,3,250,20,8
2024,maret,TEJA,PANEMPAN,200,1,5,177,0,183,6,3.278688525
2024,maret,TEJA,KANGENAN,357,4,3,336,0,343,7,2.040816327
2024,maret,TEJA,PATEMON,316,0,5,311,1,317,5,1.577287066
2024,maret,TEJA,BARURAMBAT KOTA,524,2,0,501,0,503,2,0.397614314
2024,maret,TEJA,PARTEKER,265,4,0,248,0,252,4,1.587301587
2024,maret,TEJA,JUNGCANGCANG,411,0,4,380,0,384,4,1.041666667
2024,maret,KOWEL,BETTET,318,3,0,157,11,171,3,1.754385965
2024,maret,KOWEL,NYLABU LAOK,289,0,6,170,2,178,6,3.370786517
2024,maret,KOWEL,NYLABU DAYA,484,1,1,184,1,187,2,1.069518717
2024,maret,KOWEL,BUGIH,765,0,4,508,1,513,4,0.779727096
2024,maret,KOWEL,GLADAK ANYAR,1158,0,4,518,3,525,4,0.761904762
2024,maret,KOWEL,KOLPAJUNG,537,0,1,388,7,396,1,0.252525253
2024,maret,KOWEL,KOWEL,694,2,9,407,0,418,11,2.631578947
2024,maret,KOWEL,TORONAN,257,1,3,191,0,195,4,2.051282051
2024,maret,PROPPO,TOKET,252,0,1,155,0,156,1,0.641025641
2024,maret,PROPPO,KARANGANYAR,139,0,3,71,2,76,3,3.947368421
2024,maret,PROPPO,SAMIRAN,208,5,8,109,2,124,13,10.48387097
2024,maret,PROPPO,PROPPO,244,8,16,63,0,87,24,27.5862069
2024,maret,PROPPO,MAPPER,243,1,5,85,0,91,6,6.593406593
2024,maret,PROPPO,PANGLEMAH,141,1,8,90,0,99,9,9.090909091
2024,maret,PROPPO,BILLA'AN,294,0,7,138,1,146,7,4.794520548
2024,maret,PROPPO,TLANGOH,193,0,1,20,0,21,1,4.761904762
2024,maret,PROPPO,KODIK,135,0,3,68,1,72,3,4.166666667
2024,maret,PROPPO,LENTENG,95,1,0,29,0,30,1,3.333333333
2024,maret,PROPPO,SAMATAN,194,0,10,133,0,143,10,6.993006993
2024,maret,PROPPO,KLAMPAR,457,3,1,203,6,213,4,1.877934272
2024,maret,PROPPO,RANG PERANG LAOK,210,0,4,82,1,87,4,4.597701149
2024,maret,PROPPO,PANGURAYAN,216,1,1,65,0,67,2,2.985074627
2024,maret,PROPPO,BANYUBULU,299,1,5,117,4,127,6,4.724409449
2024,maret,PROPPO,RANG PERANG DAYA,180,0,3,154,3,160,3,1.875
2024,maret,PANAGUAN,GRO'OM,221,0,0,174,4,178,0,0
2024,maret,PANAGUAN,BATUKALANGAN,286,2,2,131,56,191,4,2.094240838
2024,maret,PANAGUAN,CANDIBURUNG,255,0,0,179,3,182,0,0
2024,maret,PANAGUAN,PANGTONGGAL,348,2,5,219,2,228,7,3.070175439
2024,maret,PANAGUAN,SRAMBAH,331,5,6,163,0,174,11,6.32183908
2024,maret,PANAGUAN,BADUNG,292,27,7,106,20,160,34,21.25
2024,maret,PANAGUAN,TATTANGOH,342,26,13,108,13,160,39,24.375
2024,maret,PANAGUAN,PANGBATOK,275,7,0,170,0,177,7,3.95480226
2024,maret,PANAGUAN,PANAGUAN,413,4,3,352,1,360,7,1.944444444
2024,maret,PANAGUAN,CAMPOR,372,4,1,257,10,272,5,1.838235294
2024,maret,PANAGUAN,JAMBRINGIN,386,4,4,289,3,300,8,2.666666667
2024,maret,PALENGAAN,BANYUPELLE,979,3,1,623,131,758,4,0.527704485
2024,maret,PALENGAAN,REK KERREK,1074,5,8,835,0,848,13,1.533018868
2024,maret,PALENGAAN,ROMBUH,234,0,0,202,1,203,0,0
2024,maret,PALENGAAN,PALENGAAN LAOK,1097,3,4,972,36,1015,7,0.689655172
2024,maret,PALENGAAN,PALENGAAN DAJA,1062,2,3,872,117,994,5,0.503018109
2024,maret,PEGANTENAN,BULANGAN BARAT,260,0,0,253,0,253,0,0
2024,maret,PEGANTENAN,PALESANGGAR,645,7,29,629,2,667,36,5.397301349
2024,maret,PEGANTENAN,PEGANTENAN,244,7,0,207,1,215,7,3.255813953
2024,maret,PEGANTENAN,TEBUL TIMUR,201,0,3,215,0,218,3,1.376146789
2024,maret,PEGANTENAN,TEBUL BARAT,92,0,1,98,0,99,1,1.01010101
2024,maret,PEGANTENAN,AMBENDER,309,1,2,429,1,433,3,0.692840647
2024,maret,PEGANTENAN,PASANGGAR,578,2,4,499,3,508,6,1.181102362
2024,maret,PEGANTENAN,TANJUNG,386,3,5,466,8,482,8,1.659751037
2024,maret,BULANGAN HAJI,PLAKPAK,731,0,13,329,5,347,13,3.746397695
2024,maret,BULANGAN HAJI,BULANGAN HAJI,437,0,3,363,0,366,3,0.819672131
2024,maret,BULANGAN HAJI,TALAGAH,136,0,2,129,0,131,2,1.526717557
2024,maret,BULANGAN HAJI,BULANGAN TIMUR,295,0,0,277,0,277,0,0
2024,maret,BULANGAN HAJI,BULANGAN BRANTA,156,0,1,132,0,133,1,0.751879699
2024,maret,KADUR,PAMAROH,324,3,20,296,1,320,23,7.1875
2024,maret,KADUR,PAMOROH,1021,15,21,507,14,557,36,6.463195691
2024,maret,KADUR,BANGKES,1155,20,37,587,15,659,57,8.649468892
2024,maret,KADUR,KADUR,958,6,42,481,6,535,48,8.971962617
2024,maret,KADUR,BUNGBARUH,466,1,12,304,2,319,13,4.07523511
2024,maret,KADUR,SOKOLELAH,146,0,0,104,1,105,0,0
2024,maret,KADUR,GAGAH,91,0,0,67,0,67,0,0
2024,maret,KADUR,KERTAGENA LAOK,153,1,17,118,0,136,18,13.23529412
2024,maret,KADUR,KERTAGENA TENGAH,488,15,34,261,3,313,49,15.65495208
2024,maret,KADUR,KERTAGENA DAYA,411,1,2,152,2,157,3,1.910828025
2024,maret,PAKONG,BICORONG,310,0,1,301,0,302,1,0.331125828
2024,maret,PAKONG,KLOMPANG BARAT,203,0,0,222,0,222,0,0
2024,maret,PAKONG,KLOMPANG TIMUR,52,0,0,119,0,119,0,0
2024,maret,PAKONG,BAJANG,112,0,0,111,0,111,0,0
2024,maret,PAKONG,CENLECEN,207,0,0,224,0,224,0,0
2024,maret,PAKONG,BANBAN,56,0,0,57,0,57,0,0
2024,maret,PAKONG,SOMALANG,71,0,0,44,0,44,0,0
2024,maret,PAKONG,PALALANG,82,0,0,103,0,103,0,0
2024,maret,PAKONG,SEDDUR,326,0,0,275,0,275,0,0
2024,maret,PAKONG,PAKONG,387,0,0,402,0,402,0,0
2024,maret,PAKONG,BANDUNGAN,198,0,0,163,0,163,0,0
2024,maret,PAKONG,LEBBEK,297,0,3,294,0,297,3,1.01010101
2024,maret,WARU,SANA LAOK,377,1,6,649,2,658,7,1.063829787
2024,maret,WARU,WARU TIMUR,641,0,11,620,0,631,11,1.743264659
2024,maret,WARU,WARU BARAT,613,0,8,790,5,803,8,0.99626401
2024,maret,WARU,TLONTOARES,128,0,1,150,0,151,1,0.662251656
2024,maret,WARU,TEGANGSER LAOK,166,1,2,239,0,242,3,1.239669421
2024,maret,TAMPOJUNG PREGI,SUMBER WARU,315,1,2,293,6,302,3,0.993377483
2024,maret,TAMPOJUNG PREGI,BAJUR,280,2,2,161,65,230,4,1.739130435
2024,maret,TAMPOJUNG PREGI,RAGANG,250,1,3,227,0,231,4,1.731601732
2024,maret,TAMPOJUNG PREGI,TAMPOJUNG TENGGINA,206,0,1,166,11,178,1,0.561797753
2024,maret,TAMPOJUNG PREGI,TAMPOJUNG TENGAH,156,1,0,141,1,143,1,0.699300699
2024,maret,TAMPOJUNG PREGI,TAMPOJUNG GUWA,73,2,0,66,0,68,2,2.941176471
2024,maret,TAMPOJUNG PREGI,TAMPOJUNG PREGI,407,0,2,366,17,385,2,0.519480519
2024,maret,BATUMARMAR,PANGERREMAN,269,0,0,161,0,161,0,0
2024,maret,BATUMARMAR,BUJUR BARAT,700,0,5,665,0,670,5,0.746268657
2024,maret,BATUMARMAR,BUJUR TENGAH,481,0,16,448,0,464,16,3.448275862
2024,maret,BATUMARMAR,BUJUR TIMUR,414,0,0,397,0,397,0,0
2024,maret,BATUMARMAR,PONJANAN TIMUR,577,1,11,535,0,547,12,2.193784278
2024,maret,BATUMARMAR,PONJANAN BARAT,326,0,1,303,0,304,1,0.328947368
2024,maret,BATUMARMAR,LESONG LAOK,237,0,2,189,0,191,2,1.047120419
2024,maret,BATUMARMAR,BANGSEREH,351,0,4,275,0,279,4,1.433691756
2024,maret,BATUMARMAR,BLABAN,451,1,14,428,0,443,15,3.386004515
2024,maret,BATUMARMAR,TAMBERU,38,0,0,0,0,0,0,0
2024,maret,BATUMARMAR,BATUBINTANG,895,0,11,695,0,706,11,1.558073654
2024,maret,BATUMARMAR,LESONG DAJA,335,1,7,178,0,186,8,4.301075269
2024,maret,BATUMARMAR,KAPONG,255,0,6,222,0,228,6,2.631578947
2024,maret,PASEAN,SANA TENGAH,324,0,5,404,1,410,5,1.219512195
2024,maret,PASEAN,SANA DAJA,324,0,3,378,1,382,3,0.785340314
2024,maret,PASEAN,DEMPO BARAT,303,0,4,290,0,294,4,1.360544218
2024,maret,PASEAN,DEMPO TIMUR,159,0,2,306,0,308,2,0.649350649
2024,maret,PASEAN,BINDANG,336,0,5,387,10,402,5,1.243781095
2024,maret,PASEAN,BATUKERBUY,310,0,4,434,0,438,4,0.913242009
2024,maret,PASEAN,TLONTORAJA,439,0,7,505,0,512,7,1.3671875
2024,maret,PASEAN,TAGANGSER DAJA,194,0,5,275,1,281,5,1.779359431
2024,maret,PASEAN,SOTABAR,253,0,3,280,0,283,3,1.060070671
2024,maret,BANDARAN,DABUAN,142,0,6,121,0,127,6,4.724409449
2024,maret,BANDARAN,TERRAK,274,0,7,194,6,207,7,3.381642512
2024,maret,BANDARAN,MANGGAR,138,0,2,108,0,110,2,1.818181818
2024,maret,BANDARAN,BANDARAN,325,1,7,317,3,328,8,2.43902439
2024,maret,BANDARAN,KRAMAT,417,0,7,309,13,329,7,2.127659574
2024,maret,BANDARAN,LARANGAN SLAMPAR,366,0,3,222,4,229,3,1.310043668
2024,maret,BANDARAN,TARO'AN,148,0,2,156,0,158,2,1.265822785
2024,maret,LARANGAN BADUNG,ANGSANAH,320,0,1,295,3,299,1,0.334448161
2024,maret,LARANGAN BADUNG,AKKOR,256,2,0,217,3,222,2,0.900900901
2024,maret,LARANGAN BADUNG,LARANGAN BADUNG,565,0,0,495,15,510,0,0
2024,maret,LARANGAN BADUNG,PANAAN,223,0,0,175,19,194,0,0
2024,maret,LARANGAN BADUNG,POTOAN LAOK,230,0,0,197,2,199,0,0
2024,maret,LARANGAN BADUNG,POTOAN DAJA,262,0,0,225,21,246,0,0
2024,maret,LARANGAN BADUNG,KACOK,278,0,0,111,125,236,0,0
